牆牆牆牆牆牆牆牆牆牆牆牆牆牆牆牆
牆　　　　牆　　　　牆　　　　牆
牆　溫泉　牆　雞窩　牆　商店　牆
牆　　　　牆　　　　牆　　　　牆
牆　　　　牆　　　　牆　　　　牆
牆○○○○牆○○○○牆○○○○牆
牆　　　　　　　　　　　　　　牆
牆　　　　　　　　　　　　　　牆
牆　　　　　　　　　　　　　　牆
牆　　　　　　　　　　　　　　牆
牆○○○○牆○○○○牆○○○○牆
牆　　　　牆　　　　牆　　　　牆
牆　　　　牆　　　　牆　　　　牆
牆　訓練　牆　探索　牆　上班　牆
牆　　　　牆　　　　牆　　　　牆
牆牆牆牆牆牆牆牆牆牆牆牆牆牆牆牆