牆牆牆牆牆牆牆牆牆牆牆牆牆牆牆
牆枕頭教櫃牆冰箱食廚房桌桌桌牆
牆床床　櫃牆　　　　　　吃　牆
牆床床　櫃牆　　　　　　　　牆
牆床床　窩牆　　　　　　　　牆
牆　　　　牆　　　　　　　　牆
牆牆牆　　牆　　牆牆牆牆牆牆角
牆櫃櫃　　　　　　　椅　　鏡牆
牆櫃櫃　　　　　　　　　　鏡牆
牆視　　　　　　　桌桌桌　椅牆
牆電　　　　　　　桌桌桌　椅牆
牆視　　　　　　　桌桌桌　椅牆
牆　　　　　　　　　　　　椅牆
牆　　　　　　　　椅椅椅椅花牆
牆牆　　牆牆牆牆牆牆牆牆牆牆牆
牆鞋　　牆倉倉倉倉牆水　馬桶牆
牆櫃　　牆庫庫庫庫牆　　　　牆
牆架　　　　　　　　　　　　牆
牆牆門牆牆牆牆牆牆牆牆牆牆牆牆